111111111
1000P0001
110011101
111011101
111011101
110011101
10CD10E01
111111111
