1111111111111
1P00000C00011
1001110000001
1010001000001
10010E0100111
1001100100C11
1111111111111