111111111
100000C01
100011101
100011101
100011101
10P00C001
100011101
10001C101
1C0010E01
111111111