111111111111111111111111111
1P0000C000000000010000000C1
100011111111111101011111101
1000111000000001001C0000101
1000111000000001CCC10010101
10000C000000000100011110101
10001111010100C10C01CC1C101
10001E110101010100010010101
1C0010C00100010000000000001
111111111111111111111111111
